5 5 5 5 5 5 5 5 5 5 5 5 5 5 5 5 5 5 5 5 5 5 5 5 5 5 5 5 5 5 5 5 5 5 5 5 5 5 5 5 5 5 5 5 5 5 5 5 5 5 
5 5 5 5 5 5 5 5 5 5 5 5 5 5 5 5 5 5 5 5 5 5 5 5 5 5 5 5 5 5 5 5 5 5 5 5 5 5 5 5 5 5 5 5 5 5 5 5 5 5 
5 5 5 5 5 5 5 5 5 5 5 5 5 5 5 5 5 5 5 5 5 5 5 5 5 5 5 5 5 5 5 5 5 5 5 5 5 5 5 5 5 5 5 5 5 5 5 5 5 5 
5 5 5 5 5 5 5 5 5 5 5 5 5 5 5 5 5 5 5 5 5 5 5 5 5 5 5 5 5 5 5 5 5 5 5 5 5 5 5 5 5 5 5 5 5 5 5 5 5 5 
5 5 5 5 5 5 5 5 5 5 5 5 5 5 5 5 5 5 5 5 5 5 5 5 5 5 5 5 5 5 5 5 5 5 5 5 5 5 5 5 5 5 5 5 5 5 5 5 5 5 
5 5 5 5 5 5 5 5 5 5 5 5 5 5 5 5 5 5 5 5 5 5 5 5 5 5 5 5 5 5 5 5 5 5 5 5 5 5 5 5 5 5 5 5 5 5 5 5 5 5 
5 5 5 5 5 5 5 5 5 5 5 5 5 5 5 5 5 5 5 5 5 5 5 5 5 5 5 5 5 5 5 5 5 5 5 5 5 5 5 5 5 5 5 5 5 5 5 5 5 5 
5 5 5 5 5 5 5 5 5 5 5 5 5 5 5 5 5 5 5 5 5 5 5 5 5 5 5 5 5 5 5 5 5 5 5 5 5 5 5 5 5 5 5 5 5 5 5 5 5 5 
5 5 5 5 5 5 5 5 5 5 5 5 5 5 5 5 5 5 5 5 5 5 5 5 5 5 5 5 5 5 5 5 5 5 5 5 5 5 5 5 5 5 5 5 5 5 5 5 5 5 
5 5 5 5 5 5 5 5 5 5 5 5 5 5 5 5 5 5 5 5 5 5 5 5 5 5 5 5 5 5 5 5 5 5 5 5 5 5 5 5 5 5 5 5 5 5 5 5 5 5 
5 5 5 5 5 5 5 5 5 5 5 5 5 5 5 5 5 5 5 5 5 5 5 5 5 5 5 5 5 5 5 5 5 19 5 5 5 5 5 5 5 5 5 5 5 5 5 5 5 5 
5 5 5 5 5 5 5 5 5 5 5 5 5 5 5 5 5 5 5 5 5 5 5 5 5 5 5 5 5 5 5 5 5 5 5 5 5 20 5 5 5 5 5 5 5 5 5 5 5 5 
5 5 5 5 5 5 5 5 5 5 22 5 5 5 5 5 5 5 5 5 5 5 5 5 5 5 5 22 5 5 5 20 5 5 22 5 5 5 5 5 5 5 5 5 5 5 5 5 5 5 
5 22 5 5 5 5 5 5 5 5 5 5 5 5 5 5 5 20 5 5 5 5 5 5 5 5 5 5 5 5 5 5 5 5 5 5 5 5 5 5 5 5 5 5 5 5 5 5 5 5 
5 5 5 5 20 22 5 5 20 5 5 5 5 22 5 5 5 20 5 5 5 5 5 5 21 5 5 17 5 19 5 5 5 12 15 15 15 15 11 5 5 20 5 5 20 5 5 5 5 5 
20 5 5 5 5 5 12 15 15 15 15 15 15 15 11 5 5 5 5 20 5 5 5 5 5 5 5 5 5 21 12 15 15 13 23 23 23 23 10 15 11 5 5 5 17 5 5 5 5 5 
5 5 5 5 5 20 13 23 23 23 23 23 23 23 10 15 15 15 11 5 5 5 17 5 5 5 21 5 5 12 13 23 23 50 23 23 23 23 48 23 10 11 5 5 22 5 5 17 5 5 
5 22 5 5 5 9 23 23 23 23 23 23 23 23 23 23 23 23 8 5 22 5 21 5 5 5 5 12 15 13 23 48 23 30 46 46 46 46 32 23 51 10 11 5 5 19 5 5 5 5 
5 5 22 5 12 13 23 23 23 23 23 23 23 23 23 23 23 23 10 11 5 5 5 5 19 5 12 13 23 23 23 23 30 47 34 34 34 34 45 32 23 23 10 11 5 5 5 20 5 5 
5 5 5 5 9 23 23 23 23 23 23 23 23 23 23 23 23 23 23 10 15 15 15 15 15 15 13 23 23 23 23 23 36 41 39 41 34 34 34 35 23 23 23 8 5 5 5 5 5 5 
5 5 5 5 9 23 23 23 23 23 23 23 23 23 23 23 23 23 23 23 23 23 23 23 23 23 23 23 23 23 23 49 23 33 45 47 34 34 34 35 23 23 23 10 11 5 22 5 5 5 
5 5 5 5 9 23 23 23 23 23 23 23 23 23 23 23 23 23 23 23 23 23 23 23 23 23 23 23 23 23 23 23 23 33 34 34 34 34 39 38 23 23 23 23 8 5 5 5 5 5 
5 22 5 5 6 7 23 23 23 23 23 23 23 23 23 23 23 23 23 23 23 23 23 23 23 23 23 23 23 23 23 50 48 33 34 34 39 37 38 23 23 48 23 23 8 5 5 19 5 5 
5 5 5 5 5 9 23 23 23 23 23 23 23 23 23 23 23 23 23 23 23 23 23 23 23 23 23 23 23 23 23 23 23 36 37 37 38 23 23 23 23 23 23 23 10 11 19 5 5 20 
5 5 5 5 5 6 7 23 23 23 23 23 23 23 23 23 23 23 23 23 23 23 23 23 23 23 23 23 23 23 23 23 23 23 23 23 23 23 49 23 23 23 23 23 23 8 5 5 5 5 
5 5 5 22 22 5 6 7 23 23 23 23 23 23 23 23 23 23 23 23 23 23 23 23 23 23 23 23 23 23 23 23 23 23 48 23 23 23 23 23 23 23 23 23 23 10 11 21 5 5 
5 5 5 5 5 5 5 6 7 23 23 23 23 23 23 23 23 23 23 23 23 23 23 23 23 23 23 23 23 23 23 23 23 23 23 23 23 23 23 23 23 23 23 23 23 23 8 5 5 5 
5 5 5 5 20 5 5 12 13 23 23 23 23 23 23 23 23 23 23 23 23 23 23 23 23 23 23 23 23 23 23 23 23 23 23 23 23 23 23 23 23 23 23 23 23 23 8 5 21 5 
5 22 5 5 5 12 15 13 23 23 23 23 23 23 23 23 23 23 23 23 23 23 23 23 23 23 23 23 23 23 23 23 23 23 23 23 23 23 23 23 23 23 23 23 23 23 8 5 5 5 
5 5 5 20 5 9 23 23 23 23 23 23 23 23 23 23 23 23 23 23 23 23 23 23 23 23 23 23 23 23 23 23 23 23 23 23 23 23 23 23 23 23 23 23 23 23 8 5 5 5 
5 5 5 5 5 9 23 23 23 23 23 23 23 23 23 23 23 23 23 23 23 23 23 23 23 23 23 23 23 23 23 23 23 23 23 23 23 23 23 23 23 23 23 23 23 3 4 5 5 5 
5 5 5 20 5 9 23 23 23 23 23 23 23 23 23 23 23 23 23 23 23 23 23 23 23 23 23 23 23 23 23 23 23 23 23 23 23 23 23 23 23 23 23 23 23 8 5 5 22 5 
5 5 5 22 5 9 23 23 23 23 23 23 23 23 23 23 23 23 23 23 23 23 23 23 23 23 23 23 23 23 23 23 23 23 23 23 23 23 23 23 23 23 23 23 3 4 5 5 5 5 
5 5 5 5 5 6 7 23 23 23 23 23 23 23 23 23 23 23 23 23 23 23 23 23 23 23 23 23 23 23 23 23 23 23 23 23 23 23 23 23 23 23 23 3 4 5 21 5 5 19 
5 5 21 5 5 5 6 1 7 23 23 23 23 23 23 23 23 23 23 23 23 23 23 23 23 23 23 23 23 23 23 23 23 23 23 23 23 23 23 23 23 23 3 4 5 5 5 5 5 5 
5 5 22 20 5 5 5 5 6 7 23 23 23 23 23 23 23 23 23 23 23 23 23 23 23 23 23 23 23 23 23 23 23 23 23 23 23 23 23 23 23 3 4 5 5 5 5 22 5 5 
5 5 5 5 5 21 5 5 5 6 1 7 23 23 23 23 23 23 23 23 23 23 23 23 23 23 23 23 23 23 23 23 23 23 23 23 3 1 1 1 1 4 5 19 5 21 5 5 5 5 
5 5 5 5 5 20 5 20 5 5 5 6 1 7 23 23 23 23 23 23 23 23 23 23 23 23 23 23 23 23 23 23 0 1 1 1 4 5 5 5 5 22 5 5 5 5 5 5 5 5 
5 5 5 5 5 5 5 5 5 5 5 5 5 6 1 7 23 23 23 23 23 23 23 23 23 23 23 23 23 3 1 1 4 5 5 5 5 5 5 5 5 5 5 5 5 5 5 5 21 5 
5 21 5 5 5 5 5 5 5 19 5 5 5 5 5 6 1 7 0 1 1 1 1 1 1 1 1 1 1 4 5 21 5 5 5 5 5 5 21 5 5 5 5 22 5 5 5 5 5 5 
5 5 5 5 5 5 5 5 5 5 20 5 5 5 5 5 5 6 4 5 5 22 5 5 5 5 5 5 5 5 5 5 5 5 5 22 5 5 5 5 5 5 5 5 5 5 5 22 5 5 
5 5 5 5 5 5 5 5 5 5 5 5 5 19 5 5 5 5 5 20 5 5 5 5 22 5 5 5 21 5 5 5 5 5 5 5 5 5 5 5 5 5 5 5 5 5 5 5 5 5 
5 5 5 5 5 5 5 5 5 5 5 5 5 5 5 5 5 5 5 5 5 5 5 5 5 5 5 5 5 5 5 5 5 20 5 5 5 5 5 5 5 5 5 5 5 5 5 5 5 5 
5 5 5 5 5 5 19 5 5 5 5 5 5 5 5 5 19 5 5 21 5 5 5 5 20 5 19 5 5 21 5 5 5 5 5 5 20 5 5 5 5 5 5 5 5 5 5 5 5 5 
5 5 5 5 5 5 5 5 5 5 20 5 5 5 5 5 5 5 5 5 5 5 20 5 5 5 5 5 5 5 5 5 5 5 5 5 5 5 5 5 5 5 5 5 5 5 5 5 5 5 
5 5 5 5 5 5 5 5 5 5 5 5 5 5 5 5 5 5 5 5 5 5 5 5 5 5 21 5 5 5 5 5 5 5 5 5 5 5 5 5 5 5 5 5 5 5 5 5 5 5 
5 5 5 5 5 5 5 5 5 5 5 5 5 5 5 5 5 5 5 5 5 5 5 5 20 5 5 5 5 5 5 5 5 5 5 5 5 5 5 5 5 5 5 5 5 5 5 5 5 5 
5 5 5 5 5 5 5 5 5 5 5 5 5 5 5 5 5 5 5 5 5 5 5 5 5 5 5 5 5 5 5 5 5 5 5 5 5 5 5 5 5 5 5 5 5 5 5 5 5 5 
5 5 5 5 5 5 5 5 5 5 5 5 5 5 5 5 5 5 5 5 5 5 5 5 5 5 5 5 5 5 5 5 5 5 5 5 5 5 5 5 5 5 5 5 5 5 5 5 5 5 
5 5 5 5 5 5 5 5 5 5 5 5 5 5 5 5 5 5 5 5 5 5 5 5 5 5 5 5 5 5 5 5 5 5 5 5 5 5 5 5 5 5 5 5 5 5 5 5 5 5 
